R 800 600
NO texture_north.xpm
SO texture_south.xpm
WE texture_west.xpm
EA texture_east.xpm
S sprite.xpm
F 255,255,255
C 0,0,0

1111111111
1000000001
1000000001
1000000001
1000000001
1000000001
1000000001
1000000001
1000000001
1111111111