NO ./textures/wolf.xpm
SO ./textures/bird.xpm
WE ./textures/fish.xpm
EA ./textures/lion.xpm
F 220,100,0
C 100,100,100

111111111111111111111111
100000000000000000000001
101111011111111101111101
100000000000000001000001
101111011111111101111101
1000000100N0001000000001
101111111011111111111101
100000000010000000000001
101111111111111111111101
100000000000000000000001
111111111111111111111111
